                M                                                                                                                                                                                         
                                                                                                                                                                                                          
                                                                          k                                                                                                                               
               BBB                                                       MMM                                                                                                                              
                                                                                                                                                               EEBBBDDD                                 GG
       M                                                                 g                                                                                                                              GG
                       BEBB                                       BEEBBBBBEEEBEBBE                                                                                                                      GG
                                                                                                                                                                                                        GG
       g                                                  D                                                        BB                                                                                   GG
     MBMBM                                               BBB                                                      BBB                                                                                   GG
                                                        DDDDD                            EEEBB                   BBBB                   g                 E     E                                       GG
                                 D                    gBBBBBBB                                                  BBBBB                  ME                EE     EE                                 GG k GG
E      k      k                 BB           k        DDDDDDDDD                   g               k            BBBBBB       k                           EEE   g EEE         k        F  E  E k     GGgggGG
GGGGGGGGGGGGGGGGGGGGGGGGGGGGGGGGGGGGGGGGGGGGGGGGGGGGGGGGGGGGGGGGGGGGGGGGGGGGGGGGGGGGGGGGGGGGGGGGGGGGGGGGGGGGGGGGGGGGGGGGGGGGGGGGGGGGGGGGGGGGGGGGGGGGGGGGGGGGGGGGGGGGGGGGGGGGGGGGGGGGGGGGGGGGGGGGGGGGGGGGGG
GGGGGGGGGGGGGGGGGGGGGGGGGGGGGGGGGGGGGGGGGGGGGGGGGGGGGGGGGGGGGGGGGGGGGGGGGGGGGGGGGGGGGGGGGGGGGGGGGGGGGGGGGGGGGGGGGGGGGGGGGGGGGGGGGGGGGGGGGGGGGGGGGGGGGGGGGGGGGGGGGGGGGGGGGGGGGGGGGGGGGGGGGGGGGGGGGGGGGGGGGG