                M                                                                                                                                                                                         
                                                                                                                                                                                                          
                                                                                                                                                                                                          
               BBB                                                       MMM                                                                                                                              
                                                                                                                                                                                                          
       M                                                                 g                                                                                                                B B B      B B B
                       BEBB                                       BEEBBBBBEEEBEBBE                                                                                                        BBBBB      BBBBB
                                                                                                                                                                                          BBBBB      BBBBB
       g                                                  D                                                        BB                                                                     GGGGGGGGGGGGGGGG
     MBMBM                                               BBB                                                      BBB                                                                     GGGGGGGGGGGGGGGG
                                                        DDDDD                            EEEBB                   BBBB                   g                 E     E                         GGGGGGG  GGGGGGG
                                 D                    gBBBBBBB                                                  BBBBB                  ME                EE     EE                        GGGGGG    GGGGGG
                                BB                    DDDDDDDDD                   g                            BBBBBB                                   EEE   g EEE                  F    GGGGGG    GGGGGG
GGGGGGGGGGGGGGGGGGGGGGGGGGGGGGGGGGGGGGGGGGGGGGGGGGGGGGGGGGGGGGGGGGGGGGGGGGGGGGGGGGGGGGGGGGGGGGGGGGGGGGGGGGGGGGGGGGGGGGGGGGGGGGGGGGGGGGGGGGGGGGGGGGGGGGGGGGGGGGGGGGGGGGGGGGGGGGGGGGGGGGGGGGGGGGGGGGGGGGGGGG
GGGGGGGGGGGGGGGGGGGGGGGGGGGGGGGGGGGGGGGGGGGGGGGGGGGGGGGGGGGGGGGGGGGGGGGGGGGGGGGGGGGGGGGGGGGGGGGGGGGGGGGGGGGGGGGGGGGGGGGGGGGGGGGGGGGGGGGGGGGGGGGGGGGGGGGGGGGGGGGGGGGGGGGGGGGGGGGGGGGGGGGGGGGGGGGGGGGGGGGGGG