                M                                                                                                                                                                                         
                                                                                                                                                                                                          
                                                                                                                                                                                                          
               BBB                                                       MMM                                                                                                                              
                                                                                                                                                                                                          
       M                                                                 g                                                                                                                                
                       BEBB                                       BEEBBBBBEEEBEBBE                                                                                                                        
                                                                                                                                                                                                          
       g                                                  D                                                        BB                                                                                     
     MBMBM                                               BBB                                                      BBB                                                                                     
                                                        DDDDD                            EEEBB                   BBBB                   g                 E     E                                       GG
                                 D                    gBBBBBBB                                                  BBBBB                  ME                EE     EE                                 GG   GG
                                BB                    DDDDDDDDD                   g                            BBBBBB                                   EEE   g EEE                  F             GGgggGG
GGGGGGGGGGGGGGGGGGGGGGGGGGGGGGGGGGGGGGGGGGGGGGGGGGGGGGGGGGGGGGGGGGGGGGGGGGGGGGGGGGGGGGGGGGGGGGGGGGGGGGGGGGGGGGGGGGGGGGGGGGGGGGGGGGGGGGGGGGGGGGGGGGGGGGGGGGGGGGGGGGGGGGGGGGGGGGGGGGGGGGGGGGGGGGGGGGGGGGGGGG
GGGGGGGGGGGGGGGGGGGGGGGGGGGGGGGGGGGGGGGGGGGGGGGGGGGGGGGGGGGGGGGGGGGGGGGGGGGGGGGGGGGGGGGGGGGGGGGGGGGGGGGGGGGGGGGGGGGGGGGGGGGGGGGGGGGGGGGGGGGGGGGGGGGGGGGGGGGGGGGGGGGGGGGGGGGGGGGGGGGGGGGGGGGGGGGGGGGGGGGGGG