                M                                                                                                                                                                                                                                    GG
                                                                                                                                                                                                                                                     GG
                                                                          k                                                                                                                                                                          GG
               BBB                                                       MMM                                                                                                                                                                         GG
                                                                                                                                                               EEBBBDDD                                                                              GG
       M                                                                 g                                                                                                                                                                           GG
                       BEBB                          B            BEEBBBBBEEEBEBBE                                                                                                                                  DD                               GG
                                                                                                                                                                                                                    DD                               GG
       g                                                  D                                                        BB                                                                                        DD     DD                               GG
     MBMBM                                               BBB                                                      BBB                                                                                  DD    DD     DD                               GG
                                                        DDDDD                            EEEBB                   BBBB                   g                 E     E                       D   D          DD    DD     DD                               GG
                                 D                    gBBBBBBB                                                  BBBBB                  ME                EE     EE                                     BB    BB     DD                          GG k GG
E      k      k                 BB           k        DDDDDDDDD                   g               k            BBBBBB       k                           EEE   g EEE         k          D     D    kkkk        k   k DD              F  E  E k   GGgggGG
GGGGGGGGGGGGGGGGGGGGGGGGGGGGGGGGGGGGGGGGGGGGGGGGGGGGGGGGGGGGGGGGGGGGGGGGGGGGGGGGGGGGGGGGGGGGGGGGGGGGGGGGGGGGGGGGGGGGGGGGGGGGGGGGGGGGGGGGGGGGGGGGGGGGGGGGGGGGGGGGGGGGGGGGGGGGGGGGGGGGGGGG     GGGGGGGGGGGGGGGGGGGGGGGGGGGGGGGGGGGGGGGGGGGGGGGGGGGGGGGGGG
GGGGGGGGGGGGGGGGGGGGGGGGGGGGGGGGGGGGGGGGGGGGGGGGGGGGGGGGGGGGGGGGGGGGGGGGGGGGGGGGGGGGGGGGGGGGGGGGGGGGGGGGGGGGGGGGGGGGGGGGGGGGGGGGGGGGGGGGGGGGGGGGGGGGGGGGGGGGGGGGGGGGGGGGGGGGGGGGGGGGGGGG     GGGGGGGGGGGGGGGGGGGGGGGGGGGGGGGGGGGGGGGGGGGGGGGGGGGGGGGGGG