                M                                                                                                                                                                                         
                                                                                                                                                                                                          
                                                                                                                                                                                                          
               BBB                                                       MMM                                                                                                                              
                                                                                                                                                                                                          
       M                                                                 g                                                                                                                                
                       BEBB                                       BEEBBBBBEEEBEBBE                                                                                                                        
                                                                                                                               BEDD                                                                       
       g                                                  D                                                                                M                                                              
     MBMBM                                               BBB                                                                                                                                              
                                                        DDDDD                            EEEBB                   BBBB                    DDEEBBBB                                                         
                M                                                                                                                                                                                         
                                                                                                                                                                                                          
                                                                                                                                                                                                          
               BBB                                                       MMM                                                                                                                              
                                                                                                                                                               EEBBBDDD                                 GG
       M                                                                 g                                                                                                                              GG
                       BEBB                                       BEEBBBBBEEEBEBBE                                                                                                                      GG
                                                                                                                                                                                                        GG
       g                                                  D                                                        BB                                                                                   GG
     MBMBM                                               BBB                                                      BBB                                                                                   GG
                                                        DDDDD                            EEEBB                   BBBB                   g                 E     E                                       GG
                                 D                    gBBBBBBB                                                  BBBBB                  ME                EE     EE                                 GG   GG
                                BB                    DDDDDDDDD                   g                            BBBBBB                                   EEE   g EEE                  F             GGgggGG
GGGGGGGGGGGGGGGGGGGGGGGGGGGGGGGGGGGGGGGGGGGGGGGGGGGGGGGGGGGGGGGGGGGGGGGGGGGGGGGGGGGGGGGGGGGGGGGGGGGGGGGGGGGGGGGGGGGGGGGGGGGGGGGGGGGGGGGGGGGGGGGGGGGGGGGGGGGGGGGGGGGGGGGGGGGGGGGGGGGGGGGGGGGGGGGGGGGGGGGGGG
GGGGGGGGGGGGGGGGGGGGGGGGGGGGGGGGGGGGGGGGGGGGGGGGGGGGGGGGGGGGGGGGGGGGGGGGGGGGGGGGGGGGGGGGGGGGGGGGGGGGGGGGGGGGGGGGGGGGGGGGGGGGGGGGGGGGGGGGGGGGGGGGGGGGGGGGGGGGGGGGGGGGGGGGGGGGGGGGGGGGGGGGGGGGGGGGGGGGGGGGGG