                M                                                                                                                                                                                         
                                                                                                                                                                                                          
                                                                                                                                                                                                          
               BBB                                                       MMM                                                                                                                              
                                                                                                                                                                                                          
       M                                                                 g                                                                                                                                
                       BEBB                                       BEEBBBBBEEEBEBBE                                                                                                                        
                                                                                                                                                                                                          
       g                                                  D                                                        BB                                                                                   GG
     MBMBM                                               BBB                                                      BBB                                                                                   GG
                                                        DDDDD                            EEEBB                   BBBB                   g                 E     E                                   G   GG
                M                                                                                                                                                                                    ggg  
                                                                                                                                                                                                     ggg  
                                                                                                                                                                                                     ggg  
               BBB                                                       MMM                                                                                                                         ggg  
                                                                                                                                                                                                     ggg  
       M                                                                 g                                                                                                                           ggg  
                       BEBB                                       BEEBBBBBEEEBEBBE                                                                                                                   ggg  
                                                                                                                                                                                                     ggg  
       g                                                  D                                                        BB                                                                                gggGG
     MBMBM                                               BBB                                                      BBB                                                                                gggGG
                                                        DDDDD                            EEEBB                   BBBB                   g                 E     E                                    gggGG
                                 D                    gBBBBBBB                                                  BBBBB                  ME                EE     EE                                 GGgggGG
                                BB                    DDDDDDDDD                   g                            BBBBBB                                   EEE   g EEE                  F             GGgggGG
GGGGGGGGGGGGGGGGGGGGGGGGGGGGGGGGGGGGGGGGGGGGGGGGGGGGGGGGGGGGGGGGGGGGGGGGGGGGGGGGGGGGGGGGGGGGGGGGGGGGGGGGGGGGGGGGGGGGGGGGGGGGGGGGGGGGGGGGGGGGGGGGGGGGGGGGGGGGGGGGGGGGGGGGGGGGGGGGGGGGGGGGGGGGGGGGGGGGGGGGGG
GGGGGGGGGGGGGGGGGGGGGGGGGGGGGGGGGGGGGGGGGGGGGGGGGGGGGGGGGGGGGGGGGGGGGGGGGGGGGGGGGGGGGGGGGGGGGGGGGGGGGGGGGGGGGGGGGGGGGGGGGGGGGGGGGGGGGGGGGGGGGGGGGGGGGGGGGGGGGGGGGGGGGGGGGGGGGGGGGGGGGGGGGGGGGGGGGGGGGGGGGG