                M                                                                                                                                                                                       GG
                                                                                                                                                                                                        GG
                                                                                                                                                                                                        GG
               BBB                                                       MMM                                                                                                                            GG
                                                                                                                                                                                                        GG
       M                                                                                                                                                                                                GG
                       BEBB                                       BEEBBBBBEEEBEBBE                                                                                                                      GG
                                                                                                                                                                                                        GG
                                                          D                                                        BB                                                                                   GG
     MBMBM                                               BBB                                                      BBB                                                                                   GG
                                                        DDDDD                            EEEBB                   BBBB                                     E     E                                       GG
                                 D                     BBBBBBB                                                  BBBBB                  ME                EE     EE                                      GG
                                BB                    DDDDDDDDD                                                BBBBBB                                   EEE   g EEE                             g F     GG
GGGGGGGGGGGGGGGGGGGGGGGGGGGGGGGGGGGGGGGGGGGGGGGGGGGGGGGGGGGGGGGGGGGGGGGGGGGGGGGGGGGGGGGGGGGGGGGGGGGGGGGGGGGGGGGGGGGGGGGGGGGGGGGGGGGGGGGGGGGGGGGGGGGGGGGGGGGGGGGGGGGGGGGGGGGGGGGGGGGGGGGGGGGGGGGGGGGGGGGGGG
GGGGGGGGGGGGGGGGGGGGGGGGGGGGGGGGGGGGGGGGGGGGGGGGGGGGGGGGGGGGGGGGGGGGGGGGGGGGGGGGGGGGGGGGGGGGGGGGGGGGGGGGGGGGGGGGGGGGGGGGGGGGGGGGGGGGGGGGGGGGGGGGGGGGGGGGGGGGGGGGGGGGGGGGGGGGGGGGGGGGGGGGGGGGGGGGGGGGGGGGGG