BBBBBBBBBBBBBBBBBBBBBBBBBBBBBBBBBBBBBBBBBBBBBBBBBBBBBBBBBBBBBBBBBBBBBBBBBBBBBBBBBBBBBBBBBBBBBBBBBBBBBBBBBBBBBBBBBBBBBBBBBBBBBBBBBBBBBBBBBBBBBBBBBBBBBBBBBBBBBBBBBBBBBBBBBBBBBBBBBBBBBBBBBBBBBBBBBBBBBBBBBBBBBBBBBBBBBBBBBBBBBBBBBBBBBBBBBBBBBBBBBBBBBBBBB
                         D                                                                                                                                                                                                                              
                        MD                      g                                                                                                                                                            g    B                                      
                         D   BBBBBBBBBBBBBBBBBBBBBBBBBBBBBBBBBBBBBBBBBBBBBBBBBBBBBBBBBBBBBBBBBBBBBBBBBBBBBBBBBBBBBBBBBBBBBBBBBBBBBBBBBBBBBBBBBBBBBBBBBBBBBBBBBBBBBBBBBBBBBBBBBBBBBBBBBBBBBBBBBBBBBBBBBBBBBBBBBBBBB                                       
    BBBB      B   k  B   D                                                                B      B                                          D           D                                                                                                
              DBBMMBBD  DD                                                                B      B                                          D           D                                                         MMM                                    
              D                                                     DD                           B           B                          DD  D           D                                                 BB                                             
              D            BB    MM                          DD                                  B          BD         MMM              DD  D     BMMM  D  BBBB                BBBB                 BB    BB                                             
  MM          Dg      D                               DD                                  B      B         BDD                          DD       BD        D g                  g D           BB    BB    BB      MMM                                    
              DBBBBBBDD                        DD                           B      B      B               BDDD                        DDDD      BDD        Dgg                  ggD                       DD                                             
              DBBBBBBD   Bg       gB    DD                                  B  kk  B      B              BDDDD                        DDDD     BDDDg       Dgk k k k k k k k k k gD                       DD            F                                
BBBBBBBBBBBBBBDBBBBBBD   DDDDDDDDDDD                                        DDDDDDDD      D      D      BDDDDD   B     BBB     BBB    DDDD  BBBBBBBBBBBBBBBDBBBBBBBBBBBBBBBBBBBBBBDGGGGGGGGGGGGGGGGGGGGGGGGGGGGGGGGGGGGGGGGGGGGGGGGGGGGGGG               
BBBBBBBBBBBBBBDBBBBBBD   DDDDDDDDDDD                                        DDDDDDDD      D      D      BDDDDD   B     BBB     BDB    DDDD  BBBBBBBBBBBBBBDDDBBBBBBBBBBBBBBBBBBBBDDDGGGGGGGGGGGGGGGGGGGGGGGGGGGGGGGGGGGGGGGGGGGGGGGGGGGGGG               
BBBBBBBBBBBBBBDBBBBBBD   DDDDDDDDDDD                                        DDDDDDDD      D      D      BDDDDD   B     BDB     DDD    DDDD  BBBBBBBBBBBBBBDDDBBBBBBBBBBBBBBBBBBBBDDDGGGGGGGGGGGGGGGGGGGGGGGGGGGGGGGGGGGGGGGGGGGGGGGGGGGGGG               
BBBBBBBBBBBBBBDBBBBBBD   DDDDDDDDDDD                                        DDDDDDDD      D      D      BDDDDD   D     DDD     DDD    DDDD  DDDDDDDDDDDDDDDDDDDDDDDDDDDDDDDDDDDDDDDDGGGGGGGGGGGGGGGGGGGGGGGGGGGGGGGGGGGGGGGGGGGGGGGGGGGGGG               